----#####----------
----#---#----------
----#$--#----------
--###--$##---------
--#--$-$-#---------
###-#-##-#---######
#---#-##-#####--..#
#-$--$----------..#
#####-###-#@##--..#
----#-----#########
----#######--------

